3, 3
4
5, 9
10, 2
level2
0, 5
6, 3
level3
10, 0
0, 0
level5
9, 5
0, 0
level7
###0######
#--.-----#
#........#
#........#
#........#
0........0
#........#
#........#
#........#
#####0####