3, 3
4
9, 5
10, 1
level2
5, 0
7, 1
level3
10, 0
0, 0
level5
9, 5
0, 0
level7
###0######
#--.-----#
#........#
#........#
#........#
0........0
#........#
#........#
#........#
#####0####