13, 17
3
17, 14
1, 5
level1
2, 1
2, 4
level3
10, 1
5, 8
level4
####     ####
#-0#     #0-#
#==#     #==#
#==#     #==#
#==#     #==#
#==#     #==#
#==#######==#
#..-------..#
#...........#
#...........#
##########..#
---------#..######
         #..-----#
         #.......#
         #.......0
         #########
         ---------
