0, 0
2
0, 4
4, 3
level9
14, 3
1, 3
level15
3, 0
2, 12
level17
###0###  ######
#--.--#  #----#
#.....#  #....#
#.....#  #....0
0.....#  #....#
#.....#  #....#
#######  ######
-------  ------
