##########
#===.....#
#........#
#........#
#........#
#........#
####0#####