0, 0
0
     #####
  ###-----###
##---.....---##
#.............#
#......!......#
#.............#
##...........##
--###.....###--
  ---##.##---
     --*--
