0, 0
1
4, 7
2, 1
level5
#########
#.......#
#...x...#
#.......#
#.......#
#.......#
####.####
----0----
