4, 7
##########
#=.......#######
#..............#
#........#######
######.........#
  #............#
######...#######
#=.......#
####0#####