7, 8
0
     #####
  ###-----###
##---.....---##
#.............#
#......!......#
#.............#
##...........##
--###.....###--
  ---##.##---
     ##*##
     #####
     -----
