0, 0
1
7, 4
1, 2
level5
#########
#.......#
#...x...#
#.......#
#.......#
#.......#
####.####
----0----
