0, 0
4
0, 4
4, 3
level9
2, 7
2, 1
level10
14, 3
1, 3
level15
3, 0
2, 12
level17
###0###  ######
#--.--#  #----#
#.....#  #....#
#...x.#  #....0
0.....#  #....#
#.....#  #....#
##.####  ######
--0----  ------
