13, 17
3
14, 17
1, 5
level1
2, 1
0, 0
level3
10, 1
0, 0
level4
####     ####
#-0#     #0-#
#..#     #==#
#..#     #==#
#..#     #==#
#..#     #==#
#..#######==#
#..-------..#
#...........#
#...........#
##########..#
---------#..######
         #..-----#
         #.......#
         #.......0
         #########
         ---------