7, 7
4
7, 9
2, 1
exit
0, 5
16, 14
level2
10, 0
1, 16
level10
13, 3
1, 8
level11
##########0###
#--------#.#-#
#........-=-.#
#............0
#............#
0............#
#............#
#.....%......#
#######.######
-------0------