8, 5
##############################
#=....#......................############
#....##......###########................#
#=.....................................####
#=...................#.................###
#=....................#................###
#=.....................................###
#=.....................................###
####0#####################################