0, 0
2
2, 13
3, 1
level16
2, 0
11, 9
level18
##0##
#-.-#
#...#
#===#
#===#
#===#
#===#
#===#
#===#
#===#
#===#
#===#
##.##
--0--
