7, 7
4
7, 9
2, 1
exit
0, 5
16, 14
level2
10, 0
0, 0
level10
13, 3
0, 0
level11
##########0###
#--------#.#-#
#...x....-=-.#
#............0
#............#
0............#
#............#
#............#
#######.######
-------0------