0, 0
1
11, 10
2, 1
level17
       #########
    ###----*----###
 ###---.........---###
#---...=========...---#
#.....................#
#.....................#
#.....................#
-###...............###-
 ---###.........###---
    ---###...###---
       ---#0#---
