0, 0
2
11, 10
2, 1
level17
11, 1
7, 8
level19
       #########
    ###----*----###
 ###---.........---###
#---...=========...---#
#.....................#
#.....................#
#.....................#
-###...............###-
 ---###.........###---
    ---###...###---
       ---#0#---
