1, 1
1
2, 0
2, 3
level1
##0####
#.....#
#.....#
#.....#
#######