0, 0
1
3, 0
8, 17
level7
###0###
#--.--#
#.....#
#.....#
#.....#
#######
-------
