0, 0
1
0, 3
17, 8
level7
###0###
#--.--#
#.....#
#.....#
#.....#
#######
-------
