0000011100
0000110010
0000101011
0000100010
0011110100
0111110110
1111100010
0110000110
0011111100
0000110000
