0000111100
0001110100
0001101011
0001100001
0100011110
1101100100
1101000010
1110011010
0110001011
0011001101
