0111000000
1100100000
1010011100
1100111000
0111000110
0100111010
1000110001
1000000001
1100001110
0111111011
